beavis.zen	out/beavis.zen.txt
bong	out/bong.txt
bud-frogs	out/bud-frogs.txt
bunny	out/bunny.txt
cheese	out/cheese.txt
cower	out/cower.txt
daemon	out/daemon.txt
default	out/default.txt
docker	out/docker.txt
dragon	out/dragon.txt
dragon-and-cow	out/dragon-and-cow.txt
elephant	out/elephant.txt
elephant-in-snake	out/elephant-in-snake.txt
eyes	out/eyes.txt
flaming-sheep	out/flaming-sheep.txt
ghostbusters	out/ghostbusters.txt
head-in	out/head-in.txt
hellokitty	out/hellokitty.txt
kiss	out/kiss.txt
kitty	out/kitty.txt
koala	out/koala.txt
kosh	out/kosh.txt
luke-koala	out/luke-koala.txt
meow	out/meow.txt
milk	out/milk.txt
moofasa	out/moofasa.txt
moose	out/moose.txt
mutilated	out/mutilated.txt
ren	out/ren.txt
satanic	out/satanic.txt
sheep	out/sheep.txt
skeleton	out/skeleton.txt
small	out/small.txt
sodomized	out/sodomized.txt
squirrel	out/squirrel.txt
stegosaurus	out/stegosaurus.txt
stimpy	out/stimpy.txt
supermilker	out/supermilker.txt
surgery	out/surgery.txt
telebears	out/telebears.txt
three-eyes	out/three-eyes.txt
turkey	out/turkey.txt
turtle	out/turtle.txt
tux	out/tux.txt
udder	out/udder.txt
vader	out/vader.txt
vader-koala	out/vader-koala.txt
www	out/www.txt
